########
#      #
# .#   #
#  $   #
#  @   #
########
